101 101
#####################################################################################################
              # # #       #   # # # # #       # #     # # #       #             #       #   #       #
# ### ### ##### # ##### ##### # # # # # ####### ### ### # # ######### # # ##### # ### ##### # ### ###
#   #   #     #         # # #         # # # #     # # # #   # # # #   # # #       # #     #     #   #
# ### ### ##### # # ### # # ### # ### # # # ### ### # # ### # # # ### ####### ### # ### ##### ### ###
# # # #     #   # # #           # #         # # # #                     # # # #     # #     #   #   #
### ### # ### # ############# ####### # ### # # # ### # ####### # # # ### # ####### # ### ### ### ###
#   #   # # # #   #   # # #   # #     # #             # # # # # # # #           #       #       #   #
### ### ### ### ### ### # ##### ### # ################### # # ### ######### ### ### ##### # # ### ###
# # #     #       # #       #       # # # # # # # # # # #       #   # # # # # # # #   # # # #   #   #
# # ### ##### # ### ##### ##### # # ### # # # # # # # # # ### ### ### # # ### ### # ### ##### ### # #
#   #       # #       #     # # # # #                 #     #   # # #       # # #     # #       # # #
# ##### ##### ##### ##### ### ### # ### ### # # ### ### ##### ##### # ### ### # # ##### ### # ##### #
#   #       #     # # # #       # # #   # # # #   #       #     #       #   #     # # #     # #     #
# ##### # ### ####### # # ### ##### ### # ##### ### # # ### # ### ### ### ####### # # ########### # #
# # # # #   # # # # #       #   # # #       #     # # # #   # #   # #   #     # #   # # # # #     # #
# # # ### ##### # # # ### ### ### ### ### ##### ##### ### # ####### # ### # ### ### # # # # ##### ###
#           #           #   #       # #   # #     #     # # # # # #     # #       #         # # #   #
# # # # # ### ### ### ### ### ### ### ### # ### ##### ### ### # # # ####### ### ### ####### # # ### #
# # # # # #   # #   # #   #     #   # #       #     #   #             #       #   # # #       #   # #
# ######### ### # ### # ######### ######### ### ##### ### # # # ### ### # # ### ##### ####### # ### #
#   #       # #     # # # # # # #     # # #   #     # #   # # #   #   # # # #     # # # # # #   # # #
# ### # ##### # ##### ### # # # ### ### # # ### # ####### ##### ### ########### ### # # # # ### # ###
#   # # # # #     # # #           #           # # #     # #       #     #   #                 #     #
# ### ### # ### ### ##### # ### ### # ##### ######### ####### # ##### ##### ### # # ##### # ### #####
#   # # #     # #   #     # # #   # #     #     #     #     # #     #   #     # # #   # # # #   # # #
# ##### # ##### ### ### # ### # ##### ##### ######### # ####### # ### ####### ##### ### ####### # # #
#   # #   # # # #       # #     # # #   #         # #   # # # # # # # # # # #   #             # #   #
# ### ### # # # ### # # ####### # # ##### # ####### # ### # # ##### ### # # # ##### # # ### ### # ###
#       #         # # #   # #         # # #       #   #             # #           # # #   #         #
# # # ### ### ### ##### ### ### ### ### ##### # ##### ### ### ### ### # ####### # ### # ### # ### ###
# # #   # #   # #   #     #   # # # #   # # # # # #   #   #   #   # # # # # # # # #   # #   #   #   #
##### ### ### # ### ### ### ##### # ### # # ##### ### ### ### ### # # # # # # ####### ### ### ##### #
# #     # #     # # #     #   # #           # # # # #     #   #               # #     #   #       # #
# ### ### ##### # ##### ### ### ### # # ### # # # # ##### ####### # # # # ### # ### # ### # # # ### #
#       #   #     # #       #       # # #             #     # #   # # # # # #       # # # # # #   # #
# # # ########### # ### ######### # ####### # # ### ##### ### ### ######### ### # # ### ####### ### #
# # # # # # # # #         # #     #   # # # # # #     #   #     #       #     # # #       #     #   #
### ### # # # # ##### # ### ### # ##### # ######### ######### ######### ### ##### # ######### # # # #
#     #           # # #   # # # #   #         # #   # # # # # # # # # # #   # # # #   # # #   # # # #
### ### ### ### ### ### ### # ### ##### ### ### ### # # # # # # # # # ##### # # ####### # ### #######
#         #   #       #         # # #     #     #                       #       # # #           #   #
# # ### ### ### ### ### # ### ##### ### ### # ##### # # # # # # # ### ######### # # ### # # # ### ###
# #   # # # #     # #   #   #   # #   # # # #   # # # # # # # # # # # # # # # #         # # #     # #
# ####### ##### ######### ### ### # ### # ### ### ############# ### # # # # # ### ### # # # ####### #
#   #     #       #       #           #     #   # # #         # #               # #   # # #     #   #
# ### ####### # ### # ######### # # ### ##### ### # ##### ### ##### # # # ### ### ### ##### # ##### #
# # # # #     # #   # # # # # # # #       #           #   #     # # # # # #   # #   # # #   #     # #
### # # ### # ### # ### # # # ##### ######### # ### ########### # ########### # ### ### ##### # ### #
#           #   # # # #         #       #   # #   #   # # # # #       # # #       # #   # #   #   # #
# # # ### # # ### ### # ### ##### # # ##### ### ### ### # # # ##### ### # ##### ####### # ##### ### #
# # # #   # # #   #       #   #   # #     # #     #             # #   #     # # # # # #     #     # #
# ####### ##### ##### ### # ####### # # ### ### ### # # # # # ### # ### ##### # # # # # ####### ### #
#       # #     # # # # # #     # # # # # # # # # # # # # # #   #       # #               #       # #
# ### ####### ### # # # ### # ### ####### # # ### ####### ### ### ### ### ### # # ### ####### # ### #
#   #   # # # #           # #       # #         # # #   # #     # # #       # # # #   # # #   #     #
# ### ### # ##### ### # ##### # # ### ### ### ### # ### ### # ### # ### ############# # # ### # # ###
#   #         #   # # # # # # # #       # #   # #   #       #   #     #           #         # # #   #
# ### # # # ##### # ##### # ##### ### ### ### # ### ### # # # ### ##### ### # ########### ##### ### #
# # # # # #     #     #             #   # # #   # #   # # # #       #     # # # # # # # # # # #   # #
### ####### # ##### ########### # ### ##### ### # ### ####### # # ### # ####### # # # # # # # ### # #
# #       # #   #   # # # # # # # #     # #   #     #       # # # #   # #   #                   # # #
# ### ####### ##### # # # # # ####### ### # ##### ### ############# # ### ####### ### ##### ##### # #
#     # #       #           # # #               # # # # # # # # # # #         #     #     #   #   # #
# ### # ### # ### # # # ### # # ##### ### ### ### # # # # # # # # ### ##### ##### ##### ### ##### ###
# #         # #   # # # # #   # # # #   #   # #                         # #   # # # # # # # #       #
##### # # # ### ######### ### # # # ##### ##### # # ##### # # # ######### ##### # # # ### ### # # # #
#     # # # #   # # # # #   # #     # # #     # # # #     # # # # # # # #   # #         # #   # # # #
### # ####### ### # # # # ### ##### # # ### ##### ##### # ### ### # # # # ### ##### ##### ### # ### #
# # #       # #             #             #   #       # #   # #                 # # # #     # # #   #
# ### # # ### ##### ### ##### # ##### ##### ##### # ### # ### ##### ### ##### ### # # ##### ##### # #
# # # # #   #   # # # #     # # # # #   #     # # #   # # #     # # # #   # #           #         # #
# # ##### ####### # # ### ####### # # ##### ### ### ##### ### ### # # ##### ### # ### ####### ### ###
#   #       # #         #     #         #         #   # # #   #       # #     # #   #     # # # #   #
# ##### # ### ### ### ### # ##### ### ### # # # ####### ### # ### ### # ### ##### ### # ### ### ### #
# #   # #   #   # # # #   # # # # #     # # # #   # #     # #   # #           #   #   #     #   # # #
# # ##### ### ### # ### # ### # ##### ######### ### ##### ### ####### # ### ########### ####### # ###
#   # #     #         # #         #   # #             # #     # # #   # #   # # # # # #   # # # #   #
### # ### ### ##### ##### # # ####### # ##### # # # ### ####### # ### ##### # # # # # ##### # # # ###
#           # # # # #     # #   #   #     #   # # #       # # #     #   #               #           #
# # # # # ### # # ### # # ### ### ### ##### ####### ### ### # ### ### ##### # ####### ##### # ### ###
# # # # # #       # # # #   # #   # #   #   # #     # #         #   # #     # # # # # # #   # # #   #
##### ########### # ##### ####### # # ####### ####### ### # # ### ############# # # # # ### ### # ###
#       # # # #     # #     # # #     # # #     # #     # # #   # # # # # # #   #           #     # #
# # # ### # # ##### # ### ### # ##### # # ### ### ### ####### ### # # # # # ### ### # # # # ##### # #
# # # # #       # #   # #         #       # # #     #   #       #             #   # # # # #   #     #
# # ### # ### ### ### # ### ### ### # ### # # ##### # ### # # ##### ### ### ##### ### ### ### ##### #
# #         #       #     #   # #   # #         # #     # # #   #     #   #     #     # # # # # # # #
# # # ### ### ### ##### ### ####### ####### ### # # ######### ##### ##### # # ##### ### ### ### # # #
# # #   #   #   # #   # # #     #       # # # #       #   #     # # # # # # #     # #   # #   #     #
##### ### ### ####### # # ### ### # ##### ### # ### ##### ### ### # # # ### # # ####### # # ### ### #
# # # # # #       # #       #   # # # # #   #     #     #                 # # #   #   #       # # # #
# # ### ### # ##### # ### ### ### ### # # ### ##### # ### ### ### # # # ####### ##### # ### ### # ###
#     #     # # # #     # #     # #   #         #   #   # #     # # # # # #       # #     #   #   # #
# ####### # ### # # ####### # ####### # ### ##### ### ### ### ########### ### # ### # ##### ##### # #
# # # #   #     #     # #   # #   # #     #     # #     # # # # #   # #     # #       # #     # # # #
# # # ### ####### ##### ### ### ### ### ### # ### ### ##### ### ### # # ####### # # ### ### ### # # #
#                     #               #   # # #   #     #               # # # # # #       # #       #
# # # # # ### # ### ##### # # ### ##### ### ### # # # ### ##### # # ### # # # ##### ### ##### ### ###
# # # # #   # #   #     # # #   #         #   # # # # #   #     # # #                 #         #    
#####################################################################################################
