101 101
#####################################################################################################
      #           #   #             # #       # # # # #         #               #       # # #       #
# # ######### ### # ####### # # ### # ####### # # # # # ### # ### ### # # # ### ### ### # # ####### #
# #     # # # # #   #       # # # #     # # #             # #   # #   # # # #       #         # # # #
### # ### # ### # ##### ######### # ##### # ####### ### ### # ##### # # ######### # # ##### ### # # #
# # #         # # #     # # # #   # # #       # #   # #   # # # # # # #     # #   # # # # #         #
# ### # ### ### # ### ### # # ### # # # ### ### ### # ######### # ########### ### ##### # # ### # ###
# # # #   #   #       #       # #       # #       #     #           # # # # #   # # # #       # #   #
# # ### ### ####### # ### ### # ####### # ### ##### ##### # ##### ### # # # # ##### # # ### ##### # #
#         #     #   #   # #     # # # # # # #     # # #   # # # #                 #       #     # # #
### # # ### # ### # # ######### # # # # # # ### ### # ### ### # # ##### # ##### ### ####### # ##### #
#   # # # # #   # # #   # # #     #           #         # #     # # # # #     #     # # # # #   #   #
### ##### ### ####### ### # ##### # ####### ##### # # ######### # # # ######### ##### # # ####### # #
#     #           #         # #     # # # #     # # #     # # #       # # # #     #       # # #   # #
### ####### # # ### # ### ### ##### # # # ### ####### # ### # ####### # # # ### ##### ### # # ##### #
#       #   # #   # #   #       #           # #   # # #         # # #         # #     #       # #   #
# # # ### # ### ### ##### ### ####### ### ####### # ### ##### ### # ### ### ######### ####### # ### #
# # # #   # #     # # #     # # # # # # #     # #           #   #     # #   # #         # # #     # #
####### # ### # ##### ### ##### # # ### # ##### ### # # # ### ### ######### # ### # # ### # ### ### #
# #     # # # #     # # #   # #       #   # # #   # # # # #         #             # # #       #   # #
# ### # ### ### # ### # ##### # ### ##### # # # ##### ##### # # # ### # ### # # # ######### ### #####
#   # # # #   # #         # #     #     #         # # # #   # # # #   # # # # # #   # # #   # # # # #
# ####### ### ### # # # ### # ##### # ### # ### ### ### ### ############# ### ####### # ### # # # # #
# # # # # # #   # # # #   # #   # # #   # # #   # #             # # # # # # # # # # #     #         #
# # # # # # # ######### ### # ### ### ### ##### # ### # # # # ### # # # # # ### # # # ####### # ### #
#             #           #     # #     # #       # # # # # #                 #       # #     # # # #
### # # ### ##### # # # ##### ### ### ####### ### # ############### # # ####### ### ### ### # ### # #
#   # # # # # # # # # #     #   #       # # # #     # # # # # # # # # #     # #   #       # # #     #
# # # ### # # # ##### # # ### ##### # ### # ### ### # # # # # # # ##### # ### # ### ############### #
# # # #             # # #       #   #         # #                 # # # #       # #         # #   # #
# ### ##### # # ### ##### ### ### # # # # # ### ######### ### ### # # ### ####### ####### ### ### # #
#   # #     # # # #   #     # #   # # # # #   #   # # # # #   #       # # # # #   # # # #       # # #
# ######### ##### ### ### ####### ######### ### ### # # ##### ### ### # ### # ### # # # ### # ### # #
#   # # # # # # # # #   # #     # #           # #         #     # #     #                 # #       #
# ### # # ### # # # # ##### ### ####### # # ####### ### ##### # ####### ### # # ##### ####### ##### #
# #         #           # # # # # #     # # #   # #   #   # # #   # #       # # # # # # #       # # #
# ### ### ### ### # ##### # # ### ### # ##### ### # ### ### ### ### ### # # # ### # # # ### # ### ###
# # #   #       # #   # #       # # # #               #       #       # # # # #           # # #   # #
### # ##### # ##### ### # ### ### # ### # # ### # # ### # # ####### ############### ### ### ##### # #
# #   # # # #     #   #     #         # # #   # # # # # # #   # # #       # # # #   # # #     # # # #
# # ### # ### # ### ### ##### ##### ####### ######### ##### ### # ##### ### # # ### # ##### ### # # #
#   #       # # #     # # # #     # #           #     #       #     # # # #       # #   #           #
### ##### ####### # ### # # ####### ### # # # ### ######### ##### ### ### # ### ### # ### # # # # ###
# #   # # # #     #   #     # # #     # # # # # # # #         # #       #     #         # # # # #   #
# # ### # # ##### # ####### # # ### ########### # # ### # # ### # ### ### ##### ### # ####### ### # #
# # #       # #   # # # # # #     # # #             #   # # # #   # #       #     # #     #     # # #
# # ### ### # ### ### # # # # ### ### ### ############# ##### ### # ### ##### # ##### # ### # # #####
#       # #     #             # # # # # # # # # # # #     # #   #     #   # # # # #   # #   # #     #
##### ### # ##### # # # ### ### ### # # # # # # # # ### ### # ### ##### ### ##### ### ### ##### ### #
#     #       #   # # #   #     #                         # # # #   #         # # # # # # #       # #
# # ####### ####################### # # # # # # # # # # ### # # # ### # ### ### # # ### ### # # ### #
# # # # # # # # # # # # # # # # #   # # # # # # # # # # #           # #   # # #             # # #   #
# ### # # # # # # # # # # # # # ### ### ### ############### # ### ########### ### ######### ##### # #
# #                               # #     #   # # # # #     # # # # # # #         # # # # # #     # #
# ### # # # # # # # # # # # # ### ##### ### ### # # # ### # ### # # # # ####### ### # # # ##### # ###
# # # # # # # # # # # # # # # # # # # # #     #           # #   #         # #   #           #   #   #
### ### ####################### # # # ### # ##### # # # # # ### # ######### ####### ### ####### # ###
#                 # # # # # #             #   #   # # # # # #     # # # # # # # #   #   # #   # #   #
# # # # # # # # ### # # # # ### # # # # # # ##### # ############# # # # # # # # ### ### # ### ### ###
# # # # # # # #   #           # # # # # # # # # # #   # #   # #                     #     # #       #
########### # # ### # ####### ############### # ### ### ### # ### # # # ### # # # # ##### # ##### ###
#           # # # # # # #   # #             #         # # # #   # # # # #   # # # # # #     # # #   #
# # ##### # # ### ##### ### # # ############### # # ### # # # ############# ######### ##### # # #####
# # #     # # # # # #     #   #   # # # # #     # # # #       # # #     # # #           #       # # #
# ### # # ##### # # ### ### ### ### # # # ##### ##### # ####### # ##### # ##### ### ########### # # #
# #   # #     #         # # #   #                 #     # # #     # # #       #   #       # #       #
####### # ##### # # ### # # # ######### # # # # ##### ### # ##### # # # ### ### ### # ##### ### ### #
# # # # #   #   # # #           # #     # # # # # #   #     # # #         #     # # #   # #     # # #
# # # ### ##### ####### # ### ### ### # ######### ### ##### # # # ### # ### # ### ### ### ### ### # #
#           #     #     # #   #   # # #   # # #   # #   # #         # #   # #       # # #   # # #   #
# # # # # ### # ##### # ##### ### # ### ### # ### # # ### # ##### ##### ####### # ##### # ##### # ###
# # # # # # # #     # # #     # #   #           #     # #   # # #   # #   # # # #   #   # # # #     #
# ######### ### # ########### # ### ### ##### ### ### # # ### # ##### ##### # ### # ### # # # # ### #
#             # #   #   # # #     # #       #   # # #     #   # # # # # # # #   # # #             # #
# ### # # ####### ### ### # # ##### ### # ### ##### ##### ### # # # # # # # # ########### ### # ### #
#   # # #   #       # #       #       # #   #   # # # # # #                       # # # #   # # #   #
# ##### # ##### # ### ####### # ######### ### ### # # # # ### # ### ### # ##### ### # # # ####### # #
#     # # #   # #   #   # # # # # # # # # #     #         # # # # #   # #     #             #     # #
# # ### ### ##### ### ### # # # # # # # ### # ### ### # ### ##### # ##### ################### ##### #
# #   # #   # #     # #                     #   # # # #       # #     #   # # # # # # # # # # #     #
# ######### # ### ### ##### # ####### # # # # ### # ### ### ### # ######### # # # # # # # # ####### #
#       # #   #         #   # #       # # # # #       #   # #         # #                   # # # # #
# ### ### ### ### ##### ######### # # ########### ### # ####### ### ### ### # # # # # ##### # # # ###
#   #   #   #         # # # # # # # # # # # # #     # #   # #   # # #       # # # # # # # #         #
# ### ### ### # # ####### # # # ### ### # # # ### ### ##### ### # ##### # # ### ####### # # #########
# #         # # # # # #           #   #         #   #   #     #   #     # # # #     #       # # # # #
### # # # ### # ### # ### ### # ### ####### ##### ### # ### ##### ### # ##### ### ####### ### # # # #
#   # # #   # # # #     #   # #   #     # # # #     # # # #   # #     # # #     #     # # # # #     #
# # ##### ####### # ##### ##### ### # ### # # # ######### # ### ##### ### ### ######### # # # # ### #
# # #         # #           #     # #           # # # # #         #       #     # # #             # #
# ### # # # ### # ### ### ### # ##### ### ### ### # # # # ### # ##### # ##### ### # ### ### # ##### #
# # # # # #   #     #   # #   #   # #   #   # # #           # #     # #   #   #       # # # # # # # #
### ####### ### ##### ##### # # ### ### ### ### # ### # ####### # ########### # ### ### # ##### # ###
#                 #       # # #   #   # # # #       # #   # # # #     # # # #     #   # #   #     # #
# # # # ### ### ##### ######### ### ##### ####### ### # ### # ### # ### # # ### ### ### # ####### # #
# # # # #     #     #     # # #         #   # # #   # # # # # # # #           #   #           #     #
# # ##### # ############### # ### ### ### ### # # ####### # # # ### # ### # ### ### # # ########### #
# #   #   # # # # # # # # #     #   # #             #           # # #   # #   #   # # #     # # # # #
# ### ### ### # # # # # # # ##### ##### ### ##### ##### # # ### # ### ##### ### ####### # ### # # # #
#   #   #                     #           #     #     # # # #         #           #     #            
#####################################################################################################
